########################################
#                                      #
# ^                                    #
#   *************     *************    #
#  *             *   *             *   #
#     ##$######         ######$##      #
#     #       #         #       #      #
#     #       #         #       #      #
#     #   ^   #    ^    #   ^   #      #
#     #       #         #       #      #
#     #       #         #       #      #
#     #########         #########      #
#                                      #
#                   #                ^ #
#                  #                   #
#                 #                    #
#                 #             F      #
#      F          #                    #
#                 #                    #
#                 ##                   #
#                             ***      #
#                              *       #
#                              *       #
#                             *        #
##                           *         #
#*#                **********     #D####
#**D  %                           #    #
#***#               $             # $* #
#****#                            # ** #
########################################